R 1920 1080
NO ./wood.xpm
SO ./colorstone.xpm
WE ./greystone.xpm
EA ./redbrick.xpm
S ./cosas.cub
F 220,100,0
C 225,30,0

1111111111111111111111
1000000000000000000001
1000000000011111111111
1000000000000000000001
1000000000N00000000001
1000000000000000000111
1000000000000000000001
1111111111111111111111