R 1920 1080
NO ./path_to_the_north_texture
SO ./path_to_the_south_texture
WE ./path_to_the_west_texture
EA ./path_to_the_east_texture

S ./path_to_the_sprite_texture
F 220,100,0
C 225,30,0

111111111111111
1N0000000000001
100111111111001
1001       1001
1001       1001
1001       1001
100111111111001111111111111111
100000000000000000000000000001
111111111111111100111111111001
               1001       1001
               1001       1001
               1001       1001
               100111111111001
               100000000000001
               111111111111111