R 1920 1080
NO ./path_to_the_north_texture
SO ./path_to_the_south_texture
WE ./path_to_the_west_texture
EA ./path_to_the_east_texture

S ./path_to_the_sprite_texture
F 220,100,0
C 225,30,0

        1111111111111111111111111
        1002000000110000000002001
        1011000001110000001000001
        1001000000000000000000000
111101111011000001110000000002001
100000000011000001110111111111111
11110110011111011100000010001
11110110011111011101010010001
11001000000101011100000010001
10000020000000011000000100001
10020000000N00001101010010001
11000001110101011111011110000
11110111 1110101 101111010001
11110111 1111111 111111111111
