R 1920 1080
NO ./cosas.cub
SO ./cohsas.cub
WE ./cosas.cub
EA ./cosas.cub

S ./cosas.cub
F 220,100,0
C 25,30,0

1111111111111111111111
1001            100001
1001            100001
1001            100001
1001            100001
1001111111111111100001
1000000001100000000001
1000000001100000000001
100000001  10000000001
100000001  10000000001
1000000001100000000001
1000000000000000000001
1000011111100001111001
10000000W0000001  1001
1000000000000001  1001
1000000000000001  1001
1000000000000001111001
1000000000000000000001
1111111111111111111111