R 1920 1080
NO ./wood.xpm
SO ./colorstone.xpm
WE ./greystone.xpm
EA ./redbrick.xpm
S ./violin.xpm
F 220,100,0
C 225,30,0

        1111111111111111111111111
        1200000000110000000000001
        1011000001110000000000001
        1001000000000000020000001
111111111011000001110000000000001
100000000011000001110111111111111
11110111111111011100000010001
11110111111111011101010010001
11000000110101011100000010001
10002000000000001100000010001
10000000000S00001101010010001
1100200111010101111101111000111
11110111 1110101 101111010001
11111111 1111111 111111111111